                                                                                    ********* #                                                #
                                                                                     **     ********************                                
                                                                                     **                        **                               
            **    #                                                                 **                          **                              
             **                        ***********************************************                           **                             
              **                      **                                          ** **                           **                            
               **  *********************************************************************************************************************        
                **  **     **       **#                                         **     **                         ****                 **       
                 **  **   **       **                                          **       **                         ****                 **      
                  **  ** **       **                                          **   *******************              ****                 **     
                   **  ***       **                                          **   **      **         **              ****                 **    
                    ** ***      **                                          **   **        **         **              ****                 **   
                     *************************************************************************************************************************  
                          **  **                    **                    **                 **         **              ****   **               
                           ****                      **                  **                   **         **              ****   **              
                            **                        ********************************************        **              ****   **             
                           *************************************************************        **         **              ****   **            
  #                           **                   **                               ** **        **         **              ****   **           
   #                           *******************************************************************************************************          
                                                 ***********************************     **        **         **              ****              
                                                                                          **        **         **              ****             
                                                                                           ************         **                              
                                                                                                      **         **                             
                #                                                                                      **         **                            
                                                        #              ************************* #      **         **                           
                                                                #       **                     **        **         **   #                      
                                                                         **                     **        **         **                         
                                                                          **                     **        **         **                        
                                                                           **                     **        **         **                       
                                                                            **                     **        **         **                      
                                                                             **                     **        **         **                     
                                                                              **             #       **        **         **                    
                                                                               **                     **        **         **                   
                                                                                **                     **        **         **                  
                                                                         **      ********************** **        **         **                 
                                                                         ***                  **  **  ** **        **         **                
                                                                         * **                  **  **  ** **        **         **               
                                                                         *  **                  **  **  ** **        **         **              
                                                                         *   **                  **  **  ** **        **         **             
                                                            ******************************        **  **  ** **        **         **            
                                                             **          *     **        **        **  **  ** **        **   #     **           
     #                                                       *************      **        **        **  **  ** **        **         **          
                                                              ***   **   **      **        **        **  **  ** **        **         **         
                                                               ***  ***  ***      **        **        **  **  ** **        **         **        
                                                                *** * ****************       **        **  **  ** **        **         **       
                                                                 *******************************        **  **  ** **        **      #  **#     
                                           #                       **********************************    **  **  ** **        **         **     
                                                #                   *    *    **     ***    **  ** **     **  **  ** **       **************    
                                                                    *    *     **    * **  **    ***       **  **  ** **      *                 
                                                                    *    *      **   *  ****     ***        **  **  ** **     *                 
                                                                    *    *       **  *   **     ** **        **  **  ** **    *                 
                                                                    *    *        ** *  ****   ***  **        **  **  ** **   *                 
                                                                    *    *         ***  *  ** *****  **        **  **  ** **  *                 
                                                                    *    *          **  *   *** * **  **        **  **  ** ** *                 
          #                                                         *    *  *************   *** *  **  **        **  **  ** ***                 
                                                                    *    *   **      ***** ** ***   **  **        **  **  ** **                 
                                                                    *    *    **     * *****   **    **  **        **  **  *                    
                                                                    *    *     **    *  ****    **    *   **        *   ** *                    
                                                                    *    *      **   *  *****   ***   *    **      **    ***                    
                                                                    *    *       **  * ** ****  * **  *     **    **      **                    
                                                            **********   *        ** ****  **** *  ** *      **  **                             
   #                                                       **       ***  *         **** *   *****   ***       ****                              
                                                          **        * ** *          **  *    ****    **        **                               
                                                         **         *  ***         **** *     ****    **      ****                              
                                                        **          *   **         * ****      ****   ***    **  **                             
                                                       **           *    **        * * **       ****  * **  **    **                            
                                                      **            *    ***       * *  **      ***** *  ****      **                           
                                                     **             *    * **      * *  ***     * *****   **        **                          
                                                    **              *    *  **     * *  * **    *  ****  **************                         
                                                   **               *    *   **    * *  *  **   *   **  **                                      
                                                  ************************    **   * *  *   **  *    ****                                       
                                                                    *    **    **  * *  *    ** *     **                                        
                                                                    *    ***    ** * *  *     ***    ****                                       
                                                                    *    * **    *** *  *      **   **  **                                      
                                                                    *    *  **    ** *  *       ** **    **                                     
                                                                    *    *   **    ***  *       ****      **                                    
                                                       #            *    *    **   ***  *       ***        **                                   
                                                                    *    *     **  * ** *       ***         **                                  
                                                                    *    *      ** * ****      ** *          **                                 
                    #                                               *    *       *** * **     *** *           **                                
                                                                    *    *        ** *  **   ** * *            **                               
                                                                    *    *         ***  *** **  * *             **                              
                                                                    *    *         ***  * ***   * *#             **                             
                                                                    *    *         * ** * **    * *               **                            
                                                                    *    *         * *******    * *                **                           
                                                                    *    **       **** *** *    * *                 **                          
                                                                    *    ***     ***** *** *    * *                  *                          
                                                                    *    * **   ** * *******    * *                  *                          
                                                                    *    *  *****  * **** **    * *                  *                          
                                                                    *    *         *** **  **   * *                  *                          
                                                                    *    *        #***  ** ***  * *                  *                          
                                               #                    *    *        ** *  **** ** * *                  *                          
                                                                    *    *       *** *  * **  *** *                  *                          
                                                                    *    *      ** * *  *      ** *                  *                          
                                                                    *    *     **  * *  *      ****                 **                          
                                                                    *    *    **   * *  *      *#**                **                           
                                                         #          *    *   **    * *  *      *                  ** #                          
                                      #                             *    *  **     * *  *      *                 **                             
                                                                    *    * **      * *  *      *                **                              
                                                                    *    ***       * *  *      *               **#                              
                                                                    *    **        * *  *      *              **                                
                                                                    *   **         * *  *      *             **                                 
                                                                    *  ***         * *  *      *            **                                  
                                                                    **** *         * *  *      *           **                                   
    #                                                                **  *         * *# *      *          **                                    
                                                                      ** *         * ** *      *         **                                     
                                                                      ****         *  * *      *        **                                      
                                                                      * **         *  * *      *       **                                       
                                                                      *  **        *  * *      *      **                                        
                                                                      *  ***       *  * *      *     **                                         
 #                                                                    *  * **      *  * *      *    **                                          
                                                                      *  *  **     *  * *      *   **           #                               
               #                                                      *  *   **    *  * *      *  **                                            
                                                                      *  *    **   *  * *     ** **                                             
                                                                      *  *     **  *  * *    ** **                                              
                                                                      *  *      ** *  * *   ** **                                               
                                                                      *  *       ***  * *  ** **                                                
                                                                      *  *        **  * * ** **                                                 
                                                                      *  *         ** * *** **                                                  
   #                                #                                 *  *         **** ** **                                                   
                                                                      *  *         * **** **                                                    
                                                                      *  *         *  *****                                                     
                                        #            #                *  *         *   ***                                                      
                                                                      *  *         *   **                                                       
                                                                      *  *         *  **                                                        
                                                                      *  *         * **                                                         
                                                                      *  *         ***                                                     #    
                                                                      *  *         **                                                           
                                                                      *  *                                                                   #  
                                                                      *  *                                                                      
                                                                      * **                                                                      
                                         #                            ***                                                                       
                                                                      **                                                                        
                                                                                                                                                
                                                                                                                                                
#                                                                    #                                                                          
                                                                                     #                                                          
                                                                                                                                                
                                                                                                                                                
                                                  #                                                                                             
                                                                                                                                                
                                                                                 #                                                              
                                                                                                                                                
                                                                                                                                                
                #                                                                                                                               