                                                                                    **        #                                                #
                                                                                    ***      **                                                 
                                     **************************************************       **                                                
            *     #                 **************************************************         **                                               
                                   ***************************************************          **                                              
                                  ******                                             **          **                                             
                   **            ******                                               **          **             **                             
                    **          ******#                                                **          *****         ***                            
                     *         ******                                                   *****************        * **                           
                     *        ******                                               ***********************       *  **                          
                     *       ******                                               **                 ******      *   **                         
                     *      ******                 ********************************                   ******     *    **                        
                     ***   ******                  **                                                  ******    *     **                    *  
                     **** ******                    **                                                  ******   *      **                      
                     **********                      *********************************************       ******  *       **                     
                     *********                     ***********************************************        ****** *        **                    
                      *******                     **************************************                   ********        **                   
  #                    ************************* ****                                  **                   ********        **       ***        
   #                   *******                 * ***                                    **                   ********        **      ****       
                       ********                * **                                      **                   ********        **      ****      
                       *********               *                                          **                   ********        ****    ****     
                           ******              *                                           ************         ********                ****    
                            ******             *                                                      **         ********                ****   
                #            ******            *                       ************************        **         **********              ****  
                              ******           *        #              **                     ** #      **         *********               **** 
                               ******          *                #       **                     **        **         **** #**                ****
                                ******         *                         **                     **        **         **** ***                ***
                                 ******        *                          **                     **        **         ********                **
                                  ******       *                           **                     **        **         ********               **
                                   ******      *                            **                     **        **         ********              **
                                    ******     *                             **                     **        **         ********             **
                                     ******    *                              **             #       **        **         ********            **
                                      ******   *                               ********************   **        **         ********           **
                                       ******  *                                             *******   **        **         ********          **
                                        ****** *                         *                   **  ****** **        **         ********         **
                                         *******                         *                    **  **  ** **        **         ********        **
                                          ******                         *                     **  **  ** **        **         ********       **
                                           *****           ***************                      **  **  ** **        **         ********      **
                                            ****           ******************************        **  **  ** **        **         ********     **
                                            ****           **************               **        **  **  ** **        **         ********    **
                                            ****           * *************               **        **  **  ** **        **   #     ********   **
     #                                      ****           * **     ************************        **  **  ** **        **         ********  **
                                            ****           *        *************************        **  **  ** **        **         ***********
                                            ****           *         *****************************    ******  ** **        **         **********
                                            ****           *          ***************************************  ** **        **         *********
                                            ****           *                          ************  **********  ** **        **      #  **#*****
                                           #****           *                           ****    ****************  ** **        *          *******
                                            ****#          *                            ****    ****************  ** **       *           ******
                                            *****          *                             ************************  ** **      ******************
                                            *** *          *                              ********************* **  ** **     ******************
                                            *** *          *                                    ***************  **  ** **    ******************
                                            *** *          *                                    ****************  **  ** **   ******************
                                            *** *          *                                     ************* **  **  ** **  *****             
                                            *** *          *                ************          ************* **  **  ** ** *****             
          #                                 *** *          *                **         **          ************* **  **  ** *******             
                                            *** *          *                 **         **          ******** **** **  **  ** ******             
                                            *** *          *                  **         **          *******  **** **  **  ********             
                                            *** *          *                   **         **          ******   **** **  ** ********             
                                            *** *          *                    **         **         ******    **** **  **********             
                                            *** *          *                     **         **        ******     **** **  *********             
                                            *** *         ************            **         **       ******      **** *********                
   #                                        *** *        ****        **            **         **      ******       **** ********                
                                            *** *       ****          **            **         **     ******        ************                
                                            *** *      ****            **            **         **    ******         ***********                
                                            *** *     ****              **            **         **   ******          *******                   
                                            *** *    ****                **            **         **  ******          *******                   
                                            *** *   ****                  **            **         ** ******          *******                   
                                            *** *  ****                    **            **         ********          *******                   
                                            *** * ****                      **            **         *******          *******                   
                                            *** *****                        **            **          *****          *******                   
                                            *** ****                          **            **         *****          *******                   
                                            *** *************************      **            **        *****          *******                   
                                            *** **                      *       **            **       *****          *******                   
                                            *** **                      *        **            **      *****          *******                   
                                            *** **                      *         **            **     *****          ******                    
                                            *** **                      *          **            **    *****          ******                    
                                            *** **     #                *           **            *    ******         ******                    
                                            *** **                      *            **           *    **** **        ******                    
                                            *** **                      *             **          *    ****  **       ******                    
                    #                       *** **                      *              **         *    ****   **      ******                    
                                            *** **                      *               **        *    ****    **     ******                    
                                            *** **                      *                **       *    ****     **    ******                    
                                            *** **                      *                 **      *#   ****      **   ******                    
                                            *** **                      **                 *      *    ****       **  ******                    
                                            *** **                      **         **      *      *    ****        ** ******                    
                                            *** **                      ***       ***      *      *    ****         ********                    
                                            *** **                      ****     ** **     *      *    ****          *******                    
                                            *** **                       ****   **   **    *      *    ****          *******                    
                                            *** **                        *******     **   *      *    ****          *******                    
                                            *** **                         **************  *      *    ****          *******                    
                                            *** **                                #   **** *      *    ****          *******                    
                                            ***#**                                     *****      *    ****          *******                    
                                            ******                                      ****      *    ****          *******                    
                                            ******                                       ******** *    ****          *******                    
                                            ******                                              ***    ****         ********                    
                                             *****                                              #**    ****        ** ******                    
                                             *****       #                                             ****       ** #******                    
                                      #      *****                                                     ****      ***********                    
                                             *****                                                     ****     ************                    
                                             *****                                                     ****    **#**********                    
                                             *****                                                     ****   **************                    
                                             *****                                                     ****  ***************                    
                                             *****                                                     **** ****************                    
                                             *****                                                     ******************                       
    #                                        *****                                    #                *****************                        
                                             *****                                                    ******************                        
                                             *****                                                   *****************                          
                                             *****                                                  *****************                           
                                             *****                                                 ************* ***                            
                                             *****                                                ************** **                             
 #                                           *****                                               *************** **                             
                                             *****                                              ****************#**                             
               #                             ******                                            ********************                             
                                             *******                                          *********************                             
                                             ********                                        *********************                              
                                             *********                                      **********************                              
                                             **********                                    **********************                               
                                              **********                                  **********************                                
                                               **********                                **********************                                 
   #                                #           **********                              **********************                                  
                                                 **********                            **********************                                   
                                                  *** ******                          **********************                                    
                                        #          **# ******                         *********************                                     
                                                   ***********                          ******************                                      
                                                   ************                       *******************                                       
                                                      **********                     *******************                                        
                                                       **********                   *******************                                    #    
                                                        **********                 *******************                                          
                                                         **********                ******************                                        #  
                                                          **********  ******************************                                            
                                                           ********** *****************************                                             
                                         #                  *********************************                                                   
                                                             *******************************                                                    
                                                              *****************************                                                     
                                                               ************                                                                     
#                                                               *****#*****                                                                     
                                                                 **********          #                                                          
                                                                   *****                                                                        
                                                                                                                                                
                                                  #                                                                                             
                                                                                                                                                
                                                                                 #                                                              
                                                                                                                                                
                                                                                                                                                
                #                                                                                                                               